############################################################
************************************************************
************************************************************
***********************************************##***********
****##*******##******************************##*************
******##*******##**************************##***************
********##*******##**********************##**********##*****
**********##*******##******************##**********##*******
************##*******##**************##**********##*********
**************##*******##**********##**********##***********
****************##*******##******************##*************
******************##*******##**************##***************
********##**********##*******##**********##*****************
******##**************##*******##******##*******************
****##********##********##*******##*************************
************##************##********************************
**********##****************##******************************
********##********##**********##*******##*******************
******##********##**************##*******##*****************
****##********##********##********##*******##***************
************##********##************##*******##*************
**********##********##********##******##*******##***********
********##********##********##**********##*******##*********
******##********##********##**************##*******##*******
****##********##********##******************##*******##*****
************##********##**********************##************
**********##********##**************@***********##**********
********##********##******************************##********
******##********##**********************************##******
****##********##***********$**************************##****
************##**********************************************
**********##************************************************
********##**************************************##**********
******##*************##***********************##************
****##*****************##*******************##**************
*************************##***************##****************
************##*************##***********##******************
**************##*************##*******##********************
****************##******************##**********************
******************##**************##***********##***********
********************##**********##***************##*********
****##****************##******##*******************##*******
******##********************##***********************##*****
********##****************##***********##*******************
**********##************##***************##*****************
************##********##*******************##***************
********************##***********************##*************
******************##***********##**************##***********
****************##***************##**************##*********
**************##*******************##**************##*******
************##***********************##**************##*****
**********##***********##**************##*******************
********##***************##**************##*****************
******##*******************##**************##***************
****##*********##************##**************##*************
*****************##************##**************##***********
*******************##************##**************##*********
**********##*********##************##**************##*******
************##*********##************##**************##*****
############################################################