############################################################
#**********************************************************#
#**********************************************************#
#**********************************************************#
#**********************************************************#
#**********************************************************#
#**********************************************************#
#**********************************************************#
#**********************************************************#
#**********************************************************#
#**********************************************************#
#**********************************************************#
#**********************************************************#
#**********************************************************#
#**********************************************************#
#**********************************************************#
#**********************************************************#
#**********************************************************#
#**********************************************************#
#**********************************************************#
#**********************************************************#
#**************************@*******************************#
#**********************************************************#
#**********************************************************#
#**********************************************************#
#**********************************************************#
#**********************************************************#
#**********************************************************#
#**********************************************************#
#**************************$*******************************#
#**********************************************************#
#**********************************************************#
#**********************************************************#
#**********************************************************#
#**********************************************************#
#**********************************************************#
#**********************************************************#
#**********************************************************#
#**********************************************************#
#**********************************************************#
#**********************************************************#
#**********************************************************#
#**********************************************************#
#**********************************************************#
#**********************************************************#
#**********************************************************#
#**********************************************************#
#**********************************************************#
#**********************************************************#
#**********************************************************#
#**********************************************************#
#**********************************************************#
#**********************************************************#
#**********************************************************#
#**********************************************************#
#**********************************************************#
#**********************************************************#
#**********************************************************#
#**********************************************************#
############################################################