############################################################
************************************************************
************************************************************
************************************************************
#***********************************************************
#***********************************************************
#***********************************************************
#***********************************************************
#***********************************************************
#***********************************************************
#***********************************************************
#***********************************************************
#***********************************************************
#******************@****************************************
#***********************************************************
#***********************************************************
#***********************************************************
#***********************************************************
#***********************************************************
#***********************************************************
#***********************************************************
#***********************************************************
#***********************************************************
#***********************************************************
#*******************************##**************************
#*******************************##**************************
######################**************************************
**************************##**********##********************
******************##******#************#******##************
******************##************##************##************
*****************************$**##**************************
######################****#************#********************
#*************************##**********##********************
#***********************************************************
#*******************************##**************************
#*******************************##**************************
#***********************************************************
#***********************************************************
#***********************************************************
#***********************************************************
#***********************************************************
#***********************************************************
#***********************************************************
#***********************************************************
#***********************************************************
#***********************************************************
#***********************************************************
#***********************************************************
#***********************************************************
#***********************************************************
#***********************************************************
#***********************************************************
#***********************************************************
#***********************************************************
#***********************************************************
#***********************************************************
************************************************************
************************************************************
************************************************************
############################################################
