############################################################
************************************************************
************************************************************
************************************************************
#***********************************************************
#***********************************************************
#***********************************************************
#***********************************************************
#********************##*************************************
#********************##*************************************
#***************##*****##***********************************
#***************##*****##***********************************
#*************##*********##*********************************
#*************##*********##*********************************
#***********##**********************************************
#***********##**********************************************
#***********************************************************
#***********************************************************
#***************************************************@*******
#***********************************************************
#***********************************************************
#***********************************************************
#***********************************************************
#***********************************************************
#*******************************##**************************
#*******************************##**************************
######################**************************************
**************************##**********##********************
******************##******#************#******##************
******************##************##************##************
*****************************$**##**************************
######################****#************#********************
#*************************##**********##********************
#***********************************************************
#*******************************##**************************
#*******************************##**************************
#***********************************************************
#***********************************************************
#***********************************************************
#***********************************************************
#***********************************************************
#***********************************************************
#**********##***********************************************
#**********##***********************************************
#************##*********************************************
#************##*********##**********************************
#**************##*******##**********************************
#**************##*****##************************************
#*********************##************************************
#*******************##**************************************
#*******************##**************************************
#***********************************************************
#***********************************************************
#***********************************************************
#***********************************************************
#***********************************************************
************************************************************
************************************************************
************************************************************
############################################################
